[
    "                ",
    "       B        ",
    "             E  ",
    " e   e   e   e  ",
    " E              ",
    "                ",
    "                ",
    "                ",
    "                ",
    "                ",
    "                ",
    "        P       "
]