[
    "                ",
    "       E        ",
    " e   e   e   e  ",
    "   e   e   e    ",
    "                ",
    "                ",
    "                ",
    "                ",
    "                ",
    "                ",
    "                ",
    "        P       "
]