[
    "                ",
    "       B        ",
    " e   e   e   e  ",
    " e   e   e   e  ",
    "                ",
    "                ",
    "                ",
    "                ",
    "                ",
    "                ",
    "                ",
    "        P       "
]