[
    "BRBGB B B              ",
    "                       ",
    "B B BRBUB              ",
    "                       ",
    "    B                  ",
    "                       ",
    "                       ",
    "                       ",
    "                       ",
    "                       ",
    "                       ",
    "                       ",
    "                       ",
    "                       ",
    "           P           "
]