[
    "B                      ",
    "                       ",
    "        D              ",
    "                       ",
    "                       ",
    "                       ",
    "                       ",
    "                       ",
    "                       ",
    "                       ",
    "                       ",
    "                       ",
    "                       ",
    "                       ",
    "           P           "
]