[
    "R B GRG G              ",
    "                       ",
    "B G G B R              ",
    "                       ",
    "                       ",
    "                       ",
    "                       ",
    "                       ",
    "                       ",
    "                       ",
    "                       ",
    "                       ",
    "                       ",
    "                       ",
    "           P           "
]