[
    "BGRBRGRRG              ",
    "BRGBGGRBR              ",
    "                       ",
    "                       ",
    "                       ",
    "                       ",
    "                       ",
    "                       ",
    "                       ",
    "                       ",
    "                       ",
    "                       ",
    "                       ",
    "                       ",
    "           P           "
]