[
    "R B G G G              ",
    "                       ",
    "B R G B R              ",
    "                       ",
    "B G R B R              ",
    "                       ",
    "                       ",
    "                       ",
    "                       ",
    "                       ",
    "                       ",
    "                       ",
    "                       ",
    "                       ",
    "           P           "
]