[
    "R BBGRGGG              ",
    "                       ",
    "B GBGBBGR              ",
    "GG                     ",
    "                       ",
    "                       ",
    "                       ",
    "                       ",
    "                       ",
    "                       ",
    "                       ",
    "                       ",
    "                       ",
    "                       ",
    "           P           "
]